******************************
  **           **          * *
*  **  ****   ****     *******
*  **  **  ** ****           *
*  **  ** **     *   **  *** *
** **     **  **      *      *
**  ** *******  **  **    ** *
*  *** **    ***  **  * *    *
* **** **  *  ***  **   *    *
*   **    ***  ** **  *  *****
**  **   ***  ** **   *    ***
**   *    *    **     *  *  **
****   ** **   **    **  *  **
**    ** **    *   ****     **
****     ****  *   ***    ** *
******    ***    ** *    *****
*****   *****       ***    ***
***   *****    ***     ** ****
**  ******   ******  ****    *
**************************** *
